111111111111111111
1E0010C00000000001
100011100000000001
111111111111111111
10P000000000000001
100C00000000000001
111111111111111111