111111111111111111111111111111111111111
10000000000000000000000000C00000000E001
1000000000000000C00000000000000C0000001
111111111111111111111111111111111111111