11111111111
1000C000001
1P0CE000001
10C00000001
10C00000001
10C01111101
10C01000001
10C0100C001
10C01E00001
11111111111