11111111111111111111
10000000000000000001
10000000000000000001
10000000000000000001
10000C00000000000001
10000000000000000001
10000000000000000001
10000000000000000001
10000000000000000001
10000000000000000001
1000P000000000000001
10000000000000000001
10000000000000000E01
11111111111111111111