111111111111111111111111111111111111111
1P0000E00000000000000000000000000000001
10000000000000000C000000000000000C00001
100000000000000000000000000000000000001
10101010101010101010101010000C000011111
100000000000000000000010111111111111111
100000000000C00000000010111111111111111
100000100000C00000000010111111111111111
100000000000C00000000010111111111111111
100000000000C00000000010111111111111111
100000000000C00000000010111111111111111
100000000000C00000000010111111111111111
10000000000000000000001E111111111111111
111111111111111111111111111111111111111