1111111
1000001
10PCE01
1000C01
1111111