111111111111111
100000000000001
100000000000001
100000000000001
10000C000000001
100000000000001
100000000000001
100000000000001
100000000000001
100000000000001
1000P0000000001
100000000000001
100000000000E01
111111111111111