1111111111111
1E0010C000001
100C111000001
1101111111101
10P0000000001
100C0000000C1
1111111111111