111111
1000C1
1P0CE1
10C001
111111