1111011111111111111
1E0010C0000P0000001
1000111000000000001
1101111111111111111
10P0000000000000011
100C000000000000001
1111111111111111111